##############################
#A# #           #           ##
# # # ### ##### ##### ##### ##
# #   # # #     #   # #   # ##
# ### # # # ##### # # # # # ##
#   #   # #   #   #   # # # ##
### ### # ### # ####### # # ##
# # #   # # #   #     # #   ##
# # # ### # ##### ### # ######
# # # # # #     #   #   #   ##
# # # # # # ####### ####### ##
#   #   # #       #         ##
# ##### # ##### ########### ##
# #   # #   #   #     #     ##
# # # ##### # ### # ### ######
# # # #   # # #   #     #   ##
# # # # # # # # ######### ####
#   # # # # #   #       #   ##
##### # # # # ##### ### ### ##
#   #   #   #       # #   # ##
# ################### ### # ##
#   #           #   #   #   ##
# # # ##### ### # ### # ### ##
# # # #   # #     #   #   # ##
### # ### # ##### # ### # # ##
#   #     # #   # #   # # # ##
# ####### # # # ##### # ### ##
#         #   #       #      #
############################B#
##############################